10 10
K........T
XX...XX...
X..K......
XXXXXXX...
....XG....
XX..XGX.K.
..K.XXX...
XX...XX.K.
S.........
XX...XX...