20 20
...K....XXXX....K...
.XXXXXX.XXXX.XXXXXX.
.........XX.........
X.XXX.XX....XX.XXX.X
X.XXX.XX.XX.XX.XXX.X
.K.XX....T.....XX.K.
.X....XX....XX....X.
.X.XX.X.G..G.X.XX.X.
.X.XX.X.G..G.X.XX.X.
......XXXXXXXX......
X..XX..........XX..X
......XXXXXXXX......
.X.X.X...S....X.X.X.
...X.KXX.XX.XXK.X...
.X....XX.XX.XX....X.
XXXXX....XX....XXXXX
K...X.XX.XX.XX.X...K
.XX.X.XX.XX.XX.X.XX.
......XX.XX.XX......
XXXXX....XX....XXXXX
....................